Gd, Gd, Gll, Gll, Gll, Gd, Gd, Gd, Gd, Gd, Gd, Gd, Gd, Gd, Gd, Gd^Edb, Gll, Gll, Gll, Gd, Gd
Gd, Gll, Rb^Edb, Rb^Edb, Rb^Edb, Gll, Gd, Gd, Gd, Gd, 2 Gd, Gd, Gd, Gd^Edb, Gd, Gll, Rb^Edb, Rb^Edb, Rb^Edb, Gll, Gd
Gd, Gll, Rb^Edb, Rb^Ecf, Rb^Edb, Gll, Gd, Gd, Gd, Gd, Gd^Edb, Gd, Gd, Gd, Gd, Gll, Rb^Edb, Rb^Ecf, Rb^Edb, Gll, Gd
Gd^Edb, Gll, Gll, Rb^Edb, Gll, Gll, Gd, Gd, Gd, Gd, Gd, Gd, Gd, Gd, Gd, Gll, Gll, Rb^Edb, Gll, Gll, Gd
Gd, Gd, Gd^Edb, Gll, Gd, Gd, Gd, Gd, Gd, Gd, Gd, Gd, Gd^Edb, Gd, Gd^Edb, Gd, Gd, Gll, Gd, Gd, Gd
Gd, Gd, Gd, Gd, Gd, Gd^Edb, Gd, Gd, Gd, Gd, Gd, Gd, Gd, Gd, Gd^Edb, Gd, Gd, Gd, Gd, Gd, Gd
Gd^Edb, Gd, Gd, Gd, Gd, Gd, Gd, Gd^Edb, Gd, Gd, Gd, Gd^Edb, Gd, Gd, Gd, Gd, Gd, Gd, Gd^Edb, Gd, Gd
Gd, Gd, Gd, Gd, Gd, Gd, Gd, Gd, Gd, Gd, Gd, Gd, Gd^Edb, Gd, Gd, Gd, Gd, Gd, Gd, Gd, Gd
Gs, Gs, Gs, Gs, Gs, Gs, Gs, Gs, Gs, Gs, Gs, Gs, Gs, Gs, Gs, Gs, Gs, Gs, Gs, Gs, Gs
Gs, Gs, Gs, Gs^Gvs, Gs, Gs, Gs^Gvs, Gs, Gs, Gs, Gs, Gs, Gs, Gs, Gs, Gs, Gs, Gs^Gvs, Gs, Gs^Gvs, Gs
Gs, Gs^Gvs, Gs, Gs, Gs, Gs, Gs, Gs, Gs, Gs, Gs, Gs, Gs^Gvs, Gs, Gs^Gvs, Gs, Gs, Gs, Gs, Gs, Gs^Gvs
Gs, Gs, Gs, Gs, Gs, Gs, Gs, Gs^Gvs, Gs, Gs, Rd, Gs, Gs, Gs, Gs, Gs, Gs, Gs, Gs, Gs, Gs
Wwf, Wwf, Wwf, Wwg, Wwg, Wwg, Wwg, Wwg, Wwf, Wwf, Wwf^Bw|, Wwf, Wwf, Wwg, Wwg, Wwg, Wwg, Wwg, Wwf, Wwf, Wwf
Gs^Fms, Gs^Fms, Gs^Fms, Gs^Fms, Gs, Ce, Gs, Gs^Fms, Gg^Efm, Ce, Rd, Ce, Gg^Efm, Gs^Fms, Gs, Ce, Gs, Gs^Fms, Gs^Fms, Gs^Fms, Gs^Fms
Gs^Fms, Gs^Fms, Gs^Fms, Gg^Efm, Gs, Rd, Gs, Gg^Efm, Gs, Gs, Rd, Gs, Gs, Gg^Efm, Gs, Rd, Gs, Gg^Efm, Gs^Fms, Gs^Fms, Gs^Fms
Gs^Fms, Gs^Fms, Gs^Vl, Gs, Rd, Rd, Rd, Gs^Vl, Rd, Rd, Ce, Rd, Rd, Gs^Vl, Rd, Rd, Rd, Gs, Gs^Vl, Gs^Fms, Gs^Fms
Gll^Fp, Gll^Fp, Gll^Fp, Rd, Gs, Gs^Vl, Gs, Rd, Rd, Ce, 1 Ket, Ce, Rd, Rd, Gs, Gs^Vl, Gs, Rd, Gll^Fp, Gll^Fp, Gll^Fp
Gll^Fp, Gll^Fp, Gll^Fp, Gs, Re^Gvs, Re^Gvs, Re^Gvs, Gs^Vl, Rd, Ce, Ce, Ce, Rd, Gs^Vl, Re^Gvs, Re^Gvs, Re^Gvs, Gs, Gll^Fp, Gll^Fp, Gll^Fp
Gll^Fp, Gll^Fp, Gll^Fp, Gll^Fp, Re^Gvs, Re^Gvs, Re^Gvs, Re^Gvs, Re^Gvs, Rd, Rd, Rd, Re^Gvs, Re^Gvs, Re^Gvs, Re^Gvs, Re^Gvs, Gll^Fp, Gll^Fp, Gll^Fp, Gll^Fp
Gll^Fp, Gll^Fp, Gll^Fp, Gll^Fp, Re^Gvs, Re^Gvs, Re^Gvs, Re^Gvs, Re^Gvs, Gs, Rd, Gs, Re^Gvs, Re^Gvs, Re^Gvs, Re^Gvs, Re^Gvs, Gll^Fp, Gll^Fp, Gll^Fp, Gll^Fp
Gll^Fp, Gll^Fp, Gll^Fp, Gll^Fp, Re^Gvs, Re^Gvs, Re^Gvs, Re^Gvs, Re^Gvs, Gs, Rd, Gs, Re^Gvs, Re^Gvs, Re^Gvs, Re^Gvs, Re^Gvs, Gll^Fp, Gll^Fp, Gll^Fp, Gll^Fp
