Gs, Gs, Gs^Efm, Gs, Gg, Gg, Gll^Fp, Gll^Fp, Gll^Fp, Gll^Fp, Gll^Fp, Gll^Fp, Gll^Fp, Gs, Gll^Fp, Gll^Fp, Gll^Fp, Gll^Fp, Gll^Gvs, Gll^Gvs, Gll^Gvs, Gll^Gvs, Gll^Gvs, Gll^Gvs, Gll^Gvs, Gll^Gvs, Gll^Gvs, Gll^Fp, Gll^Fp, Gll^Fp, Gll^Fp, Gs, Gll^Fp, Gll^Fp, Gll^Fp, Gll^Fp, Gll^Fp, Gll^Fp, Gll^Fp, Gg, Gg, Gs, Gs^Efm, Gs, Gs
Gs, Gs^Efm, Gs^Efm, Gs^Efm, Gg, Gll^Fp, Gll^Fp, Gs^Fds, Gll^Fp, Gll^Fp, Gs^Fds, Gll^Fp, Gll^Feth, Gll^Fp, Gll^Fp, Gs^Fds, Gll^Gvs, Gll^Fp, Gll^Gvs, Gll^Gvs, Gll^Gvs, Gll^Gvs, Re^Edb, Gll^Gvs, Gll^Gvs, Gll^Gvs, Gll^Gvs, Gll^Fp, Gll^Gvs, Gs^Fds, Gll^Fp, Gll^Fp, Gll^Feth, Gll^Fp, Gs^Fds, Gll^Fp, Gll^Fp, Gs^Fds, Gll^Fp, Gll^Fp, Gg, Gs^Efm, Gs^Efm, Gs^Efm, Gs
Gs, Gs^Efm, Gs^Efm, Gs^Efm, Gs, Gg, Gll^Fp, Gll^Fp, Gll^Fp, Gll^Em, Gll^Fp, Gll^Fp, Gll^Fmw, Gll^Fp, Gs, Gll^Gvs, Gll^Gvs, Gll^Gvs, Re^Edb, Re^Edb, Re^Vct, Re^Edb, Ce, Re^Edb, Re^Vct, Re^Edb, Re^Edb, Gll^Gvs, Gll^Gvs, Gll^Gvs, Gs, Gll^Fp, Gll^Fmw, Gll^Fp, Gll^Fp, Gll^Em, Gll^Fp, Gll^Fp, Gll^Fp, Gg, Gs, Gs^Efm, Gs^Efm, Gs^Efm, Gs
Gg, Gg, Gg, Gs, Gs, Gg, Gg, Gll^Fmw, Gg, Gll^Fp, Gs, Gll^Fp, Gll^Gvs, Gg^Em, Gg, Gs^Vl, Re, Re^Edb, Re^Vct, Cer^Edb, Cer^Edb, Ce, 2 Ke, Ce, Cer^Edb, Cer^Edb, Re^Vct, Re^Edb, Re, Gs^Vl, Gg, Gg^Em, Gll^Gvs, Gll^Fp, Gs, Gll^Fp, Gg, Gll^Fmw, Gg, Gg, Gs, Gs, Gg, Gg, Gg
Gll^Fp, Gll^Fp, Gll^Fp, Gg, Gll^Gvs, Gll^Gvs, Gll^Gvs, Gll^Gvs, Gs, Gg, Gll^Gvs, Gll^Gvs, Gll^Gvs, Gll^Gvs, Gll^Gvs, Gs, Gs, Gs^Edb, Re, Cer^Edb, Re^Vct, Ce, Ce, Ce, Re^Vct, Cer^Edb, Re, Gs^Edb, Gs, Gs, Gll^Gvs, Gll^Gvs, Gll^Gvs, Gll^Gvs, Gll^Gvs, Gg, Gs, Gll^Gvs, Gll^Gvs, Gll^Gvs, Gll^Gvs, Gg, Gll^Fp, Gll^Fp, Gll^Fp
Gll^Fp, Gll^Fp, Gs^Fms, Gg, Gg, Gll^Gvs, Gll^Gvs, Gll^Gvs, Gll^Gvs, Gs^Vl, Gll^Gvs, Gll^Gvs, Gll^Gvs, Gll^Gvs, Gll^Gvs, Gs, Gs, Gs^Efm, Gs^Efm, Re, Gs^Efm, Re^Edb, Re^Edb, Re^Edb, Gs^Efm, Re, Gs^Efm, Gs^Efm, Gs, Gs, Gll^Gvs, Gll^Gvs, Gll^Gvs, Gll^Gvs, Gll^Gvs, Gs^Vl, Gll^Gvs, Gll^Gvs, Gll^Gvs, Gll^Gvs, Gg, Gg, Gs^Fms, Gll^Fp, Gll^Fp
Gll^Fmw, Gs^Fds, Gs^Fms, Gll^Fp, Gg, Gs, Gs, Gll^Gvs, Gg, Re, Re, Gll^Gvs, Gll^Gvs, Gll^Gvs, Gll^Fp, Gg, Gg, Gs^Efm, Gs^Efm, Gs^Efm, Gs^Efm, Gs^Edb, Re, Gs^Edb, Gs^Efm, Gs^Efm, Gs^Efm, Gs^Efm, Gg, Gg, Gll^Fp, Gll^Gvs, Gll^Gvs, Gll^Gvs, Re, Re, Gg, Gll^Gvs, Gs, Gs, Gg, Gll^Fp, Gs^Fms, Gs^Fds, Gll^Fmw
Gll^Fp, Gll^Fp, Gg^Em, Gg, Gs, Gs, Gll^Fp, Gll^Fp, Gll^Fp, Gll^Fp, Re^Es, Gs, Gll^Gvs, Gll^Gvs, Gll^Fp, Gs^Fms, Gg, Gs, Re, Gs, Re, Gs, Re, Gs, Re, Gs, Re, Gs, Gg, Gs^Fms, Gll^Fp, Gll^Gvs, Gll^Gvs, Gs, Re^Es, Gll^Fp, Gll^Fp, Gll^Fp, Gll^Fp, Gs, Gs, Gg, Gg^Em, Gll^Fp, Gll^Fp
Gll^Fp, Gll^Fp, Ww^Ewl, Gs, Gll^Gvs, Gll^Gvs, Gll^Gvs, Gll^Fp, Ww^Ewl, Gll^Fp, Gg, Re, Gs, Gg, Gg, Gg, Re, Re, Gs^Vl, Re, Gll^Gvs, Re^Es, Re, Re^Es, Gll^Gvs, Re, Gs^Vl, Re, Re, Gg, Gg, Gg, Gs, Re, Gg, Gll^Fp, Ww^Ewl, Gll^Fp, Gll^Gvs, Gll^Gvs, Gll^Gvs, Gs, Ww^Ewl, Gll^Fp, Gll^Fp
Gll^Fp, Ss, Ww^Ewl, Wwg, Gg, Gll^Gvs, Gll^Gvs, Gll^Gvs, Gs, Gg, Re, Re, Re, Gs, Gs, Re, Gll^Gvs, Gll^Gvs, Gll^Gvs, Gll^Gvs, Gll^Gvs, Gs, Re, Gs, Gll^Gvs, Gll^Gvs, Gll^Gvs, Gll^Gvs, Gll^Gvs, Re, Gs, Gs, Re, Re, Re, Gg, Gs, Gll^Gvs, Gll^Gvs, Gll^Gvs, Gg, Wwg, Ww^Ewl, Ss, Gll^Fp
Gll^Fp, Gs^Fds, Gll^Fp, Gll^Fp, Gll^Fp, Gll^Gvs, Gs, Gs, Gs, Re, Gll^Gvs, Gs, Gll^Gvs, Gs^Vl, Re, Re^Es, Gll^Gvs, Gll^Gvs, Gll^Gvs, Gll^Gvs, Gll^Gvs, Gs, Re, Gs, Gll^Gvs, Gll^Gvs, Gll^Gvs, Gll^Gvs, Gll^Gvs, Re^Es, Re, Gs^Vl, Gll^Gvs, Gs, Gll^Gvs, Re, Gs, Gs, Gs, Gll^Gvs, Gll^Fp, Gll^Fp, Gll^Fp, Gs^Fds, Gll^Fp
Gll^Fp, Gll^Fp, Gll^Fp, Gll^Em, Gs^Fds, Gll^Fp, Re, Gs^Vl, Re, Re, Gll^Gvs, Gll^Gvs, Gll^Gvs, Gll^Gvs, Gll^Gvs, Re, Re, Gll^Gvs, Gll^Gvs, Gll^Gvs, Wog, Wog, Wog^Bw|, Wog, Wog, Gll^Gvs, Gll^Gvs, Gll^Gvs, Re, Re, Gll^Gvs, Gll^Gvs, Gll^Gvs, Gll^Gvs, Gll^Gvs, Re, Re, Gs^Vl, Re, Gll^Fp, Gs^Fds, Gll^Em, Gll^Fp, Gll^Fp, Gll^Fp
Gll^Fp, Gs^Fds, Rb, Gll^Fmw, Gll^Fp, Re, Gll^Gvs, Gll^Gvs, Gll^Gvs, Gs, Gll^Gvs, Gll^Gvs, Gll^Gvs, Gll^Gvs, Gll^Gvs, Gll^Gvs, Gs, Re, Wog, Wog, Wog, Wog, Wog^Bw|, Wog, Wog, Wog, Wog, Re, Gs, Gll^Gvs, Gll^Gvs, Gll^Gvs, Gll^Gvs, Gll^Gvs, Gll^Gvs, Gs, Gll^Gvs, Gll^Gvs, Gll^Gvs, Re, Gll^Fp, Gll^Fmw, Rb, Gs^Fds, Gll^Fp
Gll^Fmw, Rb, Rb^Ecf, Rb, Re, Re^Es, Gll^Gvs, Gll^Gvs, Gll^Gvs, Gg, Gll^Fp, Gll^Gvs, Gll^Gvs, Gll^Gvs, Gll^Gvs, Gll^Gvs, Wog, Wog, Wog, Wog, Rb, Rb, Rb, Rb, Rb, Wog, Wog, Wog, Wog, Gll^Gvs, Gll^Gvs, Gll^Gvs, Gll^Gvs, Gll^Gvs, Gll^Fp, Gg, Gll^Gvs, Gll^Gvs, Gll^Gvs, Re^Es, Re, Rb, 4 Rb^Ecf, Rb, Gll^Fmw
Gs^Fds, Rb, Rb, Rb, Re, Gs, Gll^Gvs, Gll^Gvs, Gll^Gvs, Gll^Gvs, Gll^Gvs, Gg^Efm, Gs, Gll^Gvs, Wog, Wog, Wog, Wog, Rb, Rb, Re, Re, Re, Re, Re, Rb, Rb, Wog, Wog, Wog, Wog, Gll^Gvs, Gs, Gg^Efm, Gll^Gvs, Gll^Gvs, Gll^Gvs, Gll^Gvs, Gll^Gvs, Gs, Re, Rb, Rb, Rb, Gs^Fds
Gll^Fp, Gll^Fp, Gll^Fp, Gg, Re, Gs^Efm, Gg, Gll^Gvs, Gll^Gvs, Gll^Gvs, Gs, Gs, Wog, Wog, Wog, Wog, Rb, Rb, Re, Re, Ket, Hh, Re, Hh, Ket, Re, Re, Rb, Rb, Wog, Wog, Wog, Wog, Gs, Gs, Gll^Gvs, Gll^Gvs, Gll^Gvs, Gg, Gs^Efm, Re, Gg, Gll^Fp, Gll^Fp, Gll^Fp
Gll^Fp, Gll^Fp, Gg, Gg, Gs^Vl, Gs, Gll^Fp, Gll^Fp, Gg^Efm, Gs, Gs, Wog, Wog, Wog, Rb, Rb, Re, Re, Gll^Fms, Hh, Re, Re, Re, Re, Re, Hh, Gll^Fms, Re, Re, Rb, Rb, Wog, Wog, Wog, Gs, Gs, Gg^Efm, Gll^Fp, Gll^Fp, Gs, Gs^Vl, Gg, Gg, Gll^Fp, Gll^Fp
Gg, Gg, Gs^Efm, Gs, Gs, Re, Gg, Gll^Fp, Gg, Gs, Wog, Wog, Wog, Rb, Re, Re, Gll^Vc, Gll^Vl, Re, Re, Gll^Gvs, Gll^Vl, Re, Gll^Vl, Gll^Gvs, Re, Re, Gll^Vl, Gll^Vc, Re, Re, Rb, Wog, Wog, Wog, Gs, Gg, Gll^Fp, Gg, Re, Gs, Gs, Gs^Efm, Gg, Gg
Gg, Gs^Efm, Gg^Efm, Gs^Efm, Gs, Re, Ce, Gg^Efm, Gs, Gs, Wog, Wog, Rb, Rb, Re, Gll^Fms, Re^Edt, Re^Edt, Gll^Gvs, Gll^Fp, Re, Re, Re, Re, Re, Gll^Fp, Gll^Gvs, Re^Edt, Re^Edt, Gll^Fms, Re, Rb, Rb, Wog, Wog, Gs, Gs, Gg^Efm, Ce, Re, Gs, Gs^Efm, Gg^Efm, Gs^Efm, Gg
Gs^Fds, Gg, Gs^Fms, Gg, Gs, Re, Re^Es, Gs, Gg, Gs, Wog, Wog, Rb, Re, Hh, Re, Re, Gll^Vl, Re, Re^Edt, Gll^Vl, Gll^Fp, Gll^Vl, Gll^Fp, Gll^Vl, Re^Edt, Re, Gll^Vl, Re, Re, Hh, Re, Rb, Wog, Wog, Gs, Gg, Gs, Re^Es, Re, Gs, Gg, Gs^Fms, Gg, Gs^Fds
Gll^Fp, Gll^Fp, Gll^Fp, Gg, Gg, Ss, Gs^Vl, Gg, Gs^Fds, Gg, Wog, Wog, Rb, Re, Ket, Re, Gll^Vl, Re, Re, Gll^Fp, Ce, Ce, Ce, Ce, Ce, Gll^Fp, Re, Re, Gll^Vl, Re, Ket, Re, Rb, Wog, Wog, Gg, Gs^Fds, Gg, Gs^Vl, Ss, Gg, Gg, Gll^Fp, Gll^Fp, Gll^Fp
Gll^Fp, Gll^Fp, Ss, Gll^Fp, Ss, Gg, Re, Gg, Gs^Fms, Gll^Fp, Wog, Wog, Rb, Re, Hh, Re, Gll^Gvs, Re, Gll^Fp, Gll^Vl, Ce, Cv^Fds, Ket, Cv^Fds, Ce, Gll^Vl, Gll^Fp, Re, Gll^Gvs, Re, Hh, Re, Rb, Wog, Wog, Gll^Fp, Gs^Fms, Gg, Re, Gg, Ss, Gll^Fp, Ss, Gll^Fmw, Gll^Fp
Wog, Wog, Wog, Wog, Wog, Wog, Wwg^Bw|, Wog, Wog, Wog, Wog, Wog, Rb, Re, Gll^Vc, Re^Es, Gll^Fp, Re, Gll^Vl, Ce, Cv^Fds, Ket, 3 Ket, Ket, Cv^Fds, Ce, Gll^Vl, Re, Gll^Fp, Re^Es, Gll^Vc, Re, Rb, Wog, Wog, Wog, Wog, Wog, Wwg^Bw|, Wog, Wog, Wog, Wog, Wog, Wog
Gll^Fp, Wog, Ss, Wog, Ss, Wog, Re, Wog, Gs^Fms, Wog, Wog, Wog, Rb, Re, Hh, Re^Es, Gll^Gvs, Re, Gll^Fp, Ce, Ce, Ket, Ket, Ket, Ce, Ce, Gll^Fp, Re, Gll^Gvs, Re^Es, Hh, Re, Rb, Wog, Wog, Wog, Gs^Fms, Wog, Re, Wog, Ss, Wog, Ss, Wog, Gll^Fp
Gll^Fp, Gll^Fp, Gll^Fp, Gll^Fp, Gg, Gg, Gs^Vl, Gg, Gs^Fds, Gll^Fp, Wog, Wog, Rb, Re, Ket, Re, Gll^Vl, Re, Re, Gll^Vl, Ce, Cv^Fds, Ce, Cv^Fds, Ce, Gll^Vl, Re, Re, Gll^Vl, Re, Ket, Re, Rb, Wog, Wog, Gll^Fp, Gs^Fds, Gg, Gs^Vl, Gg, Gg, Gll^Fp, Gll^Fp, Gll^Fmw, Gll^Fp
Gs^Fds, Gll^Fp, Gs^Fms, Gg, Gs, Ss, Re^Es, Gg, Gg, Gg, Wog, Wog, Rb, Re, Hh, Re, Re, Re, Re, Gll^Fp, Gll^Vl, Ce, Gll^Vl, Ce, Gll^Vl, Gll^Fp, Re, Re, Re, Re, Hh, Re, Rb, Wog, Wog, Gg, Gg, Gg, Re^Es, Ss, Gs, Gg, Gs^Fms, Gll^Fp, Gs^Fds
Gg, Gg, Gg^Efm, Gg, Gs, Re, Ce, Gs, Gs, Gs, Wog, Wog, Rb, Re, Re, Re, Re^Edt, Gll^Vl, Gll^Gvs, Re^Edt, Re, Gll^Fp, Re, Gll^Fp, Re, Re^Edt, Gll^Gvs, Gll^Vl, Re^Edt, Re, Re, Re, Rb, Wog, Wog, Gs, Gs, Gs, Ce, Re, Gs, Gg, Gg^Efm, Gg, Gg
Gg, Gs^Efm, Gs^Efm, Gs^Efm, Gs, Re, Gg, Gg^Efm, Gg, Gs, Wog, Wog, Wog, Rb, Re, Gll^Fms, Gll^Vc, Re^Edt, Re, Gll^Fp, Gll^Gvs, Re, Re, Re, Gll^Gvs, Gll^Fp, Re, Re^Edt, Gll^Vc, Gll^Fms, Re, Rb, Wog, Wog, Wog, Gs, Gg, Gg^Efm, Gg, Re, Gs, Gs^Efm, Gs^Efm, Gs^Efm, Gg
Gll^Fp, Gg, Gg, Gs, Gs^Vl, Re, Gll^Fp, Gll^Fp, Gg^Efm, Gs, Gs, Wog, Wog, Rb, Rb, Re, Re, Gll^Vl, Gll^Fms, Re, Re, Gll^Vl, Re, Gll^Vl, Re, Re, Gll^Fms, Gll^Vl, Re, Re, Rb, Rb, Wog, Wog, Gs, Gs, Gg^Efm, Gll^Fp, Gll^Fp, Re, Gs^Vl, Gs, Gg, Gg, Gll^Fp
Gll^Fp, Gll^Fp, Gll^Fp, Gg, Re, Gs, Gg, Gll^Fp, Gll^Gvs, Gs, Gs, Wog, Wog, Wog, Wog, Rb, Rb, Re, Re, Hh, Ket, Re, Re, Re, Ket, Hh, Re, Re, Rb, Rb, Wog, Wog, Wog, Wog, Gs, Gs, Gll^Gvs, Gll^Fp, Gg, Gs, Re, Gg, Gll^Fp, Gll^Fp, Gll^Fp
Gs^Fds, Gll^Fp, Rb, Gg, Re, Gs^Efm, Gll^Gvs, Gll^Gvs, Gll^Gvs, Gll^Gvs, Gll^Gvs, Gs, Gs, Wog, Wog, Wog, Wog, Rb, Rb, Re, Re, Hh, Re, Hh, Re, Re, Rb, Rb, Wog, Wog, Wog, Wog, Gs, Gs, Gll^Gvs, Gll^Gvs, Gll^Gvs, Gll^Gvs, Gll^Gvs, Gs^Efm, Re, Gg, Rb, Gll^Fp, Gs^Fds
Gll^Fmw, Rb, Rb^Ecf, Rb, Re, Gs, Gll^Gvs, Gll^Gvs, Gll^Gvs, Gll^Gvs, Gll^Fp, Gg^Efm, Gll^Gvs, Gll^Gvs, Gll^Gvs, Wog, Wog, Wog, Wog, Rb, Rb, Re, Rb, Re, Rb, Rb, Wog, Wog, Wog, Wog, Gll^Gvs, Gll^Gvs, Gll^Gvs, Gg^Efm, Gll^Fp, Gll^Gvs, Gll^Gvs, Gll^Gvs, Gll^Gvs, Gs, Re, Rb, Rb^Ecf, Rb, Gll^Fmw
Gll^Fp, Rb, Rb, Rb, Gll^Fp, Re^Es, Gll^Gvs, Gll^Gvs, Gll^Gvs, Gg, Gll^Gvs, Gll^Gvs, Gll^Gvs, Gll^Gvs, Gll^Gvs, Gll^Gvs, Gs, Wog, Wog, Wog, Wog, Rb, Wog^Bw|, Rb, Wog, Wog, Wog, Wog, Gs, Gll^Gvs, Gll^Gvs, Gll^Gvs, Gll^Gvs, Gll^Gvs, Gll^Gvs, Gg, Gll^Gvs, Gll^Gvs, Gll^Gvs, Re^Es, Gll^Fp, Rb, Rb, Rb, Gll^Fp
Gll^Fp, Gs^Fds, Gll^Fp, Gll^Fmw, Gs^Fds, Re, Re, Gll^Gvs, Re, Gs, Gll^Gvs, Gll^Gvs, Gll^Gvs, Gll^Gvs, Gll^Gvs, Gll^Gvs, Re, Re, Gll^Gvs, Wog, Wog, Wog, Wog^Bw|, Wog, Wog, Wog, Gll^Gvs, Re, Re, Gll^Gvs, Gll^Gvs, Gll^Gvs, Gll^Gvs, Gll^Gvs, Gll^Gvs, Gs, Re, Gll^Gvs, Re, Re, Gs^Fds, Gll^Fmw, Gll^Fp, Gs^Fds, Gll^Fp
Gll^Fp, Gll^Fp, Gll^Fp, Gll^Em, Gll^Fp, Gll^Fp, Gs, Gs^Vl, Gs, Re, Gll^Gvs, Gll^Gvs, Gll^Gvs, Gll^Gvs, Re, Re, Gll^Gvs, Gll^Gvs, Gll^Gvs, Gll^Gvs, Gll^Gvs, Wog, Re, Wog, Gll^Gvs, Gll^Gvs, Gll^Gvs, Gll^Gvs, Gll^Gvs, Re, Re, Gll^Gvs, Gll^Gvs, Gll^Gvs, Gll^Gvs, Re, Gs, Gs^Vl, Gs, Gll^Fp, Gll^Fp, Gll^Em, Gll^Fp, Gll^Fp, Gll^Fp
Gll^Fp, Gs^Fds, Ww^Ewl, Gll^Fp, Gg, Gll^Gvs, Gll^Gvs, Gs, Gs, Re, Re, Gs, Re, Gs^Vl, Gs, Re^Es, Gll^Gvs, Gll^Gvs, Gll^Gvs, Gll^Gvs, Gll^Gvs, Gs, Re, Gs, Gll^Gvs, Gll^Gvs, Gll^Gvs, Gll^Gvs, Gll^Gvs, Re^Es, Gs, Gs^Vl, Re, Gs, Re, Re, Gs, Gs, Gll^Gvs, Gll^Gvs, Gg, Gll^Fp, Ww^Ewl, Gs^Fds, Gll^Fp
Gll^Fp, Ss, Ww^Ewl, Wwg, Gll^Gvs, Gll^Gvs, Gll^Gvs, Gll^Gvs, Ww^Ewl, Gg, Gg, Re, Gs, Gs, Gg, Re, Re, Gll^Gvs, Gs^Vl, Gll^Gvs, Gll^Gvs, Gs, Re, Gs, Gll^Gvs, Gll^Gvs, Gs^Vl, Gll^Gvs, Re, Re, Gg, Gs, Gs, Re, Gg, Gg, Ww^Ewl, Gll^Gvs, Gll^Gvs, Gll^Gvs, Gll^Gvs, Wwg, Ww^Ewl, Ss, Gll^Fp
Gll^Fp, Gll^Fp, Gg^Em, Gs, Gs, Gll^Gvs, Gll^Fp, Gll^Fp, Gll^Fp, Gll^Fp, Re^Es, Re, Gll^Gvs, Gg, Gll^Fp, Gg, Gg, Re, Re, Re, Re, Re^Es, Re, Re^Es, Re, Re, Re, Re, Gg, Gg, Gll^Fp, Gg, Gll^Gvs, Re, Re^Es, Gll^Fp, Gll^Fp, Gll^Fp, Gll^Fp, Gll^Gvs, Gs, Gs, Gg^Em, Gll^Fp, Gll^Fp
Gll^Fmw, Gll^Fp, Gs^Fms, Gg, Gg, Gs, Gs, Gll^Fp, Gg, Gll^Fp, Re, Gs, Gll^Gvs, Gll^Gvs, Gll^Fp, Gs^Fms, Gg, Gs, Gs^Efm, Gs, Gs^Efm, Gs, Re, Gs, Gs^Efm, Gs, Gs^Efm, Gs, Gg, Gs^Fms, Gll^Fp, Gll^Gvs, Gll^Gvs, Gs, Re, Gll^Fp, Gg, Gll^Fp, Gs, Gs, Gg, Gg, Gs^Fms, Gll^Fp, Gll^Fmw
Gll^Fp, Gs^Fds, Gs^Fms, Gll^Fp, Gg, Gs, Gll^Gvs, Gll^Gvs, Gll^Gvs, Re, Gll^Gvs, Gll^Gvs, Gll^Gvs, Gll^Gvs, Gll^Gvs, Gg, Gs, Gs^Efm, Gs^Efm, Gs^Efm, Gs^Efm, Gs^Edb, Re^Edb, Gs^Edb, Gs^Efm, Gs^Efm, Gs^Efm, Gs^Efm, Gs, Gg, Gll^Gvs, Gll^Gvs, Gll^Gvs, Gll^Gvs, Gll^Gvs, Re, Gll^Gvs, Gll^Gvs, Gll^Gvs, Gs, Gg, Gll^Fp, Gs^Fms, Gs^Fds, Gll^Fp
Gll^Fp, Gll^Fp, Gll^Fp, Gg, Gll^Gvs, Gll^Gvs, Gll^Gvs, Gll^Gvs, Gs, Gs^Vl, Gll^Gvs, Gll^Gvs, Gll^Gvs, Gll^Gvs, Gll^Gvs, Gs, Gs, Gs^Efm, Re, Re, Re^Vct, Re^Edb, Ce, Re^Edb, Re^Vct, Re, Re, Gs^Efm, Gs, Gs, Gll^Gvs, Gll^Gvs, Gll^Gvs, Gll^Gvs, Gll^Gvs, Gs^Vl, Gs, Gll^Gvs, Gll^Gvs, Gll^Gvs, Gll^Gvs, Gg, Gll^Fp, Gll^Fp, Gll^Fp
Gg, Gll^Fp, Gg, Gg, Gs, Gll^Gvs, Gg, Gll^Gvs, Gg, Gg, Gs, Gll^Gvs, Gll^Gvs, Gll^Gvs, Gg, Gs, Re, Gs^Edb, Re^Vct, Cer^Edb, Cer^Edb, Ce, 1 Ke, Ce, Cer^Edb, Cer, Re^Vct, Gs^Edb, Re, Gs, Gg, Gll^Gvs, Gll^Gvs, Gll^Gvs, Gs, Gg, Gg, Gll^Gvs, Gg, Gll^Gvs, Gs, Gg, Gg, Gll^Fp, Gg
Gs, Gg, Gs^Efm, Gs, Gs, Gg, Gll^Fp, Gll^Fmw, Gll^Fp, Gll^Fp, Gll^Fp, Gll^Fp, Gll^Fmw, Gg^Em, Gs, Gs^Vl, Gll^Gvs, Re^Edb, Re^Edb, Cer^Edb, Re^Vct, Ce, Ce, Ce, Re^Vct, Cer^Edb, Re^Edb, Re^Edb, Gll^Gvs, Gs^Vl, Gs, Gg^Em, Gll^Fmw, Gll^Fp, Gll^Fp, Gll^Fp, Gll^Fp, Gll^Fmw, Gll^Fp, Gg, Gs, Gs, Gs^Efm, Gg, Gs
Gs, Gs^Efm, Gs^Efm, Gs^Efm, Gg, Gg, Gll^Fp, Gll^Fp, Gll^Fp, Gll^Em, Gs^Fds, Gll^Fp, Gll^Feth, Gll^Fp, Gll^Fp, Gll^Gvs, Gll^Gvs, Gll^Gvs, Gll^Gvs, Re^Edb, Gll^Gvs, Re^Edb, Re^Edb, Re^Edb, Gll^Gvs, Re^Edb, Gll^Gvs, Gll^Gvs, Gll^Gvs, Gll^Gvs, Gll^Fp, Gll^Fp, Gll^Feth, Gll^Fp, Gs^Fds, Gll^Em, Gll^Fp, Gll^Fp, Gll^Fp, Gg, Gg, Gs^Efm, Gs^Efm, Gs^Efm, Gs
Gs, Gs^Efm, Gs^Efm, Gs^Efm, Gg, Gll^Fp, Gll^Fp, Gs^Fds, Gll^Fp, Gll^Fp, Gll^Fp, Gll^Fp, Gll^Fp, Gll^Fp, Gll^Fp, Gs^Fds, Gll^Fp, Gll^Fp, Gll^Gvs, Gll^Gvs, Gll^Gvs, Gll^Gvs, Gll^Gvs, Gll^Gvs, Gll^Gvs, Gll^Gvs, Gll^Gvs, Gll^Fp, Gll^Fp, Gs^Fds, Gll^Fp, Gll^Fp, Gll^Fp, Gll^Fp, Gll^Fp, Gll^Fp, Gll^Fp, Gs^Fds, Gll^Fp, Gll^Fp, Gg, Gs^Efm, Gs^Efm, Gs^Efm, Gs
